A	AH
A(2)	EY
ALBUM	AE L B AH M
ARE	AA R
ARE(2)	ER
CAN	K AE N
CAN(2)	K AH N
CHEMISTRY	K EH M IH S T R IY
FAVORITE	F EY V ER IH T
FAVORITE(2)	F EY V R AH T
FUNNY	F AH N IY
HELLO	HH AH L OW
HELLO(2)	HH EH L OW
HELP	HH EH L P
HI	HH AY
HOW	HH AW
IS	IH Z
JOKE	JH OW K
LAZY	L EY Z IY
ME	M IY
MILK	M IH L K
MUSIC	M Y UW Z IH K
NAME	N EY M
PASS	P AE S
PLAY	P L EY
TELL	T EH L
THANK	TH AE NG K
THE	DH AH
THE(2)	DH IY
WHAT	W AH T
WHAT(2)	HH W AH T
YOU	Y UW
YOUR	Y AO R
YOUR(2)	Y UH R
